##########
#........#
#........#
#........#
#...#....#
#...#....#
##########